......................................................................
......................................................................
.......╭╌╮............................................................
.......╰━╯............................................................
......................................................................
......................................................................
......................................................................
......................................................................
.....OO...............................................................
...........OO.........................................................
...............................⚆......................................
.......................%..⚆.%%%%%%%%%%............................╗╔..
.......................%%%%%%%%%%%%%...........╗╔.................⎜⎥..
....##........##..........⚇⚇⚇...........⚆......⎜⎥.................⎜⎥..
############################################################..########
############################################################..########
