......................................................................
......................................................................
......................................................................
......................................................................
......................................................................
......................................................................
......................................................................
......................................................................
.....OO...............................................................
......................................................................
......................................................................
.......................%.%%.%%%%%%%%%%................................
......................................................................
....##........##......................................................
############################################################..########
############################################################..########
