......................................................................
......................................................................
.......╭╌╮............................................................
.......╰━╯............................................................
......................................................................
......................................................................
......................................................................
......................................................................
.....OO...............................................................
...........OO.........................................................
......................................................................
.......................%.%%.%%%%%%%%%%................................
...............................................╗╔.....................
....##........##...............................⎜⎥.....................
############################################################..########
############################################################..########
